associatedClient --> jsAssociatedClnt
defaultScope --> jsDefScope
deployedAppliances --> jsDeplAppliances
gluuAddPersonCapability --> jsAddPersonCap
gluuAdditionalBandwidth --> jsAdditionalBandwidth
gluuAdditionalMemory --> jsAdditionalMem
gluuAdditionalUsers --> jsAdditionalUsrs
gluuApplianceDnsServer --> jsApplianceDnsServer
gluuAppliancePollingInterval --> jsAppliancePollingInterval
gluuApplianceUpdateRequestList --> jsApplianceUpdReqList
gluuApplianceUpdateReuestList --> jsApplianceUpdReuestList
gluuAttributeEditType --> jsAttrEditTyp
gluuAttributeName --> jsAttrName
gluuAttributeOrigin --> jsAttrOrigin
gluuAttributeSystemEditType --> jsAttrSystemEditTyp
gluuAttributeType --> jsAttrTyp
gluuAttributeUsageType --> jsAttrUsgTyp
gluuAttributeViewType --> jsAttrViewTyp
gluuBandwidthRX --> jsBandwidthRX
gluuBandwidthTX --> jsBandwidthTX
gluuCategory --> jsCategory
gluuConfDynamic --> jsConfDyn
gluuConfStatic --> jsConfStatic
gluuContainerFederation --> jsContainerFed
gluuCustomMessage --> jsCustomMessage
gluuDSstatus --> jsDSstatus
gluuEntityId --> jsEntityId
gluuEntityType --> jsEntityTyp
gluuFaviconImage --> jsFaviconImage
gluuFederationHostingEnabled --> jsFedHostingEnabled
gluuFreeDiskSpace --> jsFreeDiskSpace
gluuFreeMemory --> jsFreeMem
gluuFreeSwap --> jsFreeSwap
gluuGroupCount --> jsgrpCount
gluuGroupType --> jsgrpTyp
gluuGroupVisibility --> jsgrpVisibility
gluuHTTPstatus --> jsHTTPstatus
gluuHostname --> jsHostname
gluuIMAPData --> jsIMAPData
gluuInvoiceAmount --> jsInvcAmount
gluuInvoiceDate --> jsInvcDate
gluuInvoiceLineItemName --> jsInvcLineItemName
gluuInvoiceNo --> jsInvcNo
gluuInvoiceNumber --> jsInvcNumber
gluuInvoiceProductNumber --> jsInvcProductNumber
gluuInvoiceQuantity --> jsInvcQuantity
gluuInvoiceStatus --> jsInvcStatus
gluuIpAddress --> jsIpAddress
gluuIsFederation --> jsIsFed
gluuLastUpdate --> jsLastUpd
gluuLifeRay --> jsLifeRay
gluuLoadAvg --> jsLoadAvg
gluuLogoImage --> jsLogoImage
gluuManageIdentityPermission --> jsManageIdentityPermission
gluuManagedOrganizations --> jsManagedOrganizations
gluuManager --> jsManager
gluuManagerGroup --> jsManagergrp
gluuMaxLogSize --> jsMaxLogSize
gluuOptOuts --> jsOptOuts
gluuOrgProfileMgt --> jsOrgProfileMgt
gluuOrgShortName --> jsOrgShortName
gluuPaidUntil --> jsPaidUntil
gluuPassportConfiguration --> jsPassportConf
gluuPassportEnabled --> jsPassportEnabled
gluuPaymentProcessorTimestamp --> jsPaymentProcessorTimestamp
gluuPersonCount --> jsPersonCount
gluuPrivate --> jsPrivate
gluuProStoresUser --> excludeJsProStoresUsr
gluuProfileConfiguration --> jsProfileConf
gluuPublishIdpMetadata --> jsPublishIdpMetadata
gluuRadiusEnabled --> jsRadiusEnabled
gluuRegExp --> jsRegExp
gluuReleasedAttribute --> jsReleasedAttr
gluuResizeInitiated --> jsResizeInitiated
gluuRulesAccepted --> jsRulesAccepted
gluuSAML1URI --> jsSAML1URI
gluuSAML2URI --> jsSAML2URI
gluuSAMLMetaDataFilter --> jsSAMLMetaDataFilter
gluuSAMLTrustEngine --> jsSAMLTrustEngine
gluuSAMLmaxRefreshDelay --> jsSAMLmaxRefreshDelay
gluuSAMLspMetaDataFN --> jsSAMLspMetaDataFN
gluuSAMLspMetaDataSourceType --> jsSAMLspMetaDataSourceTyp
gluuSAMLspMetaDataURL --> jsSAMLspMetaDataURL
gluuSLAManager --> jsSLAManager
gluuSPTR --> jsSPTR
gluuSamlEnabled --> jsSamlEnabled
gluuScimEnabled --> jsScimEnabled
gluuShibAssertionsIssued --> jsShibAssertionsIssued
gluuShibFailedAuth --> jsShibFailedAuth
gluuShibSecurityEvents --> jsShibSecurityEvents
gluuShibSuccessfulAuths --> jsShibSuccessfulAuths
gluuSmtpFromEmailAddress --> jsSmtpFromEmailAddress
gluuSmtpFromName --> jsSmtpFromName
gluuSmtpHost --> jsSmtpHost
gluuSmtpPassword --> jsSmtpPassword
gluuSmtpPort --> jsSmtpPort
gluuSmtpRequiresAuthentication --> jsSmtpRequiresAuth
gluuSmtpRequiresSsl --> jsSmtpRequiresSsl
gluuSmtpServerTrust --> jsSmtpServerTrust
gluuSmtpUserName --> jsSmtpUsrName
gluuSpecificRelyingPartyConfig --> jsSpecificRelyingPartyConfig
gluuSslExpiry --> jsSslExpiry
gluuStatus --> jsStatus
gluuSystemUptime --> jsSystemUptime
gluuTargetRAM --> jsTargetRAM
gluuTempFaviconImage --> jsTempFaviconImage
gluuThemeColor --> jsThemeColor
gluuTooltip --> jsTooltip
gluuTrustContact --> jsTrustContact
gluuTrustDeconstruction --> jsTrustDeconstruction
gluuUrl --> jsUrl
gluuVDSenabled --> jsEnabled
gluuVDSstatus --> jsStatus
gluuValidationLog --> jsValidationLog
gluuValidationStatus --> jsValidationStatus
gluuVdsCacheRefreshEnabled --> jsCacheRefreshEnabled
gluuVdsCacheRefreshLastUpdate --> jsCacheRefreshLastUpd
gluuVdsCacheRefreshLastUpdateCount --> jsCacheRefreshLastUpdCount
gluuVdsCacheRefreshPollingInterval --> jsCacheRefreshPollingInterval
gluuVdsCacheRefreshProblemCount --> jsCacheRefreshProblemCount
gluuWhitePagesEnabled --> jsWhitePagesEnabled
gluuWhitePagesListed --> jsWhitePagesListed
oxAccessTokenAsJwt --> jsAccessTknAsJwt
oxAccessTokenLifetime --> jsAccessTknLifetime
oxAccessTokenSigningAlg --> jsAccessTknSigAlg
oxAlias --> jsAlias
oxAmHost --> jsAmHost
oxApplication --> jsApp
oxApplicationType --> jsAppTyp
oxAsJwt --> jsAsJwt
oxAssociatedClient --> jsAssociatedClnt
oxAttributes --> jsAttrs
oxAuthAppType --> jsAppTyp
oxAuthAuthorizedOrigins --> jsAuthorizedOrigins
oxAuthBackchannelAuthenticationRequestSigningAlg --> jsBackchannelAuthReqSigAlg
oxAuthBackchannelClientNotificationEndpoint --> jsBackchannelClntNotificationEndpoint
oxAuthBackchannelDeviceRegistrationToken --> jsBackchannelDeviceRegistrationTkn
oxAuthBackchannelTokenDeliveryMode --> jsBackchannelTknDeliveryMode
oxAuthBackchannelUserCode --> jsBackchannelUsrCode
oxAuthBackchannelUserCodeParameter --> jsBackchannelUsrCodeParameter
oxAuthClaim --> jsClaim
oxAuthClaimName --> jsClaimName
oxAuthClientId --> jsClntId
oxAuthClientIdIssuedAt --> jsClntIdIssuedAt
oxAuthClientSecret --> jsClntSecret
oxAuthClientSecretExpiresAt --> jsClntSecretExpAt
oxAuthClientURI --> jsClntURI
oxAuthConfDynamic --> jsConfDyn
oxAuthConfErrors --> jsConfErrors
oxAuthConfStatic --> jsConfStatic
oxAuthConfWebKeys --> jsConfWebKeys
oxAuthContact --> jsContact
oxAuthDefaultAcrValues --> jsDefaultAcrValues
oxAuthDefaultMaxAge --> jsDefaultMaxAge
oxAuthExtraConf --> jsExtraConf
oxAuthFaviconPath --> jsFaviconPath
oxAuthGrantType --> jsGrantTyp
oxAuthGroupClaims --> jsgrpClaims
oxAuthIdTokenEncryptedResponseAlg --> jsIdTknEncRespAlg
oxAuthIdTokenEncryptedResponseEnc --> jsIdTknEncRespEnc
oxAuthIdTokenSignedResponseAlg --> jsIdTknSignedRespAlg
oxAuthInitiateLoginURI --> jsInitiateLoginURI
oxAuthJwks --> jsJwks
oxAuthJwksURI --> jsJwksURI
oxAuthLogoPath --> jsLogoPath
oxAuthLogoURI --> jsLogoURI
oxAuthLogoutSessionRequired --> jsLogoutSessRequired
oxAuthLogoutURI --> jsLogoutURI
oxAuthPermissionGranted --> jsPermissionGranted
oxAuthPermissionGrantedMap --> jsPermissionGrantedMap
oxAuthPersistentJWT --> jsPersistentJWT
oxAuthPolicyURI --> jsPolicyURI
oxAuthPostLogoutRedirectURI --> jsPostLogoutRedirectURI
oxAuthRedirectURI --> jsRedirectURI
oxAuthRegistrationAccessToken --> jsRegistrationAccessTkn
oxAuthReleasedScope --> jsReleasedScope
oxAuthRequestObjectEncryptionAlg --> jsReqObjectEncryptionAlg
oxAuthRequestObjectEncryptionEnc --> jsReqObjectEncryptionEnc
oxAuthRequestObjectSigningAlg --> jsReqObjectSigAlg
oxAuthRequestURI --> jsReqURI
oxAuthRequireAuthTime --> jsRequireAuthTime
oxAuthResponseType --> jsRespTyp
oxAuthScope --> jsScope
oxAuthSectorIdentifierURI --> jsSectorIdentifierURI
oxAuthSessionAttribute --> jsSessAttr
oxAuthSessionId --> jsSessId
oxAuthSignedResponseAlg --> jsSignedRespAlg
oxAuthSkipAuthorization --> jsSkipAuthorization
oxAuthSubjectType --> jsSubjectTyp
oxAuthTokenEndpointAuthMethod --> jsTknEndpointAuthMethod
oxAuthTokenEndpointAuthSigningAlg --> jsTknEndpointAuthSigAlg
oxAuthTosURI --> jsTosURI
oxAuthTrustedClient --> jsTrustedClnt
oxAuthUmaScope --> jsUmaScope
oxAuthUserDN --> jsUsrDN
oxAuthUserId --> jsUsrId
oxAuthUserInfoEncryptedResponseAlg --> jsUsrInfEncRespAlg
oxAuthUserInfoEncryptedResponseEnc --> jsUsrInfEncRespEnc
oxAuthX509PEM --> jsX509PEM
oxAuthX509URL --> jsX509URL
oxAuthenticationData --> jsenticationData
oxAuthenticationMode --> jsenticationMode
oxCacheConfiguration --> jsCacheConf
oxClaimRedirectURI --> jsClaimRedirectURI
oxClaimValues --> jsClaimValues
oxCodeChallenge --> jsCodeChallenge
oxCodeChallengeHash --> jsCodeChallengeHash
oxConfApplication --> jsConfApp
oxConfigurationCode --> jsConfCode
oxConfigurationProperty --> jsConfProperty
oxCountInvalidLogin --> jsCountInvalidLogin
oxCounter --> jsCounter
oxCreationTimestamp --> jsCreationTimestamp
oxData --> jsData
oxDeviceData --> jsDeviceData
oxDeviceHashCode --> jsDeviceHashCode
oxDeviceKeyHandle --> jsDeviceKeyHandle
oxDeviceNotificationConf --> jsDeviceNotificationConf
oxDeviceRegistrationConf --> jsDeviceRegistrationConf
oxDisabled --> jsDisabled
oxDocumentStoreConfiguration --> jsDocStoreConf
oxDomain --> jsDomain
oxEnabled --> jsEnabled
oxEndDate --> jsEndDate
oxEnrollmentCode --> jsEnrollmentCode
oxExternalUid --> jsExternalUid
oxFaviconImage --> jsFaviconImage
oxGroup --> jsgrp
oxGuid --> jsGuid
oxHost --> jsHost
oxIDPAuthentication --> jsIDPAuth
oxIconUrl --> jsIconUrl
oxId --> jsId
oxIncludeClaimsInIdToken --> jsInclClaimsInIdTkn
oxInvolvedClients --> jsInvolvedClnts
oxJwt --> jsJwt
oxLastAccessTime --> jsLastAccessTime
oxLastLogonTime --> jsLastLogonTime
oxLevel --> jsLevel
oxLinkCreator --> excludeCreator
oxLinkExpirationDate --> excludeExpDate
oxLinkLinktrack --> excludeLinktrack
oxLinkModerated --> excludeModerated
oxLinkModerators --> excludeModerators
oxLinkPending --> excludePending
oxLinktrackEnabled --> excludetrackEnabled
oxLinktrackLogin --> excludetrackLogin
oxLinktrackPassword --> excludetrackPassword
oxLogConfigLocation --> jsLogConfigLocation
oxLogViewerConfig --> jsLogViewerConfig
oxMetricType --> jsMetricTyp
oxMobileDevices --> jsMobileDevices
oxModuleProperty --> jsModuleProperty
oxMultivaluedAttribute --> jsMultivaluedAttr
oxName --> jsName
oxNameIdType --> jsNameIdTyp
oxNickName --> jsNickName
oxOTPCache --> jsOTPCache
oxOTPDevices --> jsOTPDevices
oxPPID --> jsPPID
oxPasswordExpirationDate --> jsPasswordExpDate
oxPersistClientAuthorizations --> jsPersistClntAuthorizations
oxPolicyRule --> jsPolicyRule
oxPreferredMethod --> jsPreferredMethod
oxProxConf --> jsPrjsConf
oxProxyAccessToken --> excludeAccessTkn
oxProxyClaimMapping --> excludeClaimMapping
oxProxyClientId --> excludeClntId
oxProxyScope --> excludeScope
oxProxyToOpClientMapping --> excludeToOpClntMapping
oxPublicKeyId --> jsPublicKeyId
oxPushApplication --> jsPushApp
oxPushApplicationConf --> jsPushAppConf
oxPushDeviceConf --> jsPushDeviceConf
oxRefreshTokenLifetime --> jsRefreshTknLifetime
oxRegistrationConfiguration --> jsRegistrationConf
oxRegistrationData --> jsRegistrationData
oxRequest --> jsReq
oxRequestId --> jsReqId
oxResource --> jsResource
oxResourceSetId --> jsResourceSetId
oxRevision --> jsRevision
oxRptAsJwt --> jsRptAsJwt
oxSCIMCustomAttribute --> jsSCIMCustomAttr
oxScopeExpression --> jsScopeExpression
oxScopeType --> jsScopeTyp
oxScript --> jsScr
oxScriptDn --> jsScrDn
oxScriptError --> jsScrError
oxScriptType --> jsScrTyp
oxSectorIdentifier --> jsSectorIdentifier
oxSessionState --> jsSessState
oxSessionStateId --> jsSessStateId
oxSmtpConfiguration --> jsSmtpConf
oxSoftwareId --> jsSoftId
oxSoftwareStatement --> jsSoftStatement
oxSoftwareVersion --> jsSoftVer
oxSourceAttribute --> jsSourceAttr
oxStartDate --> jsStartDate
oxState --> jsState
oxStatus --> jsStatus
oxStrongAuthPolicy --> jsStrongAuthPolicy
oxTicket --> jsTicket
oxTrustActive --> excludeActive
oxTrustAddresses --> excludeAddresses
oxTrustAuthenticationMode --> excludeAuthMode
oxTrustCacheRefreshServerIpAddress --> excludeCacheRefreshServerIpAddress
oxTrustConfApplication --> excludeConfApp
oxTrustConfAttributeResolver --> excludeConfAttrResolver
oxTrustConfCacheRefresh --> excludeConfCacheRefresh
oxTrustConfImportPerson --> excludeConfImportPerson
oxTrustCustAttrB --> excludeCustAttrB
oxTrustEmail --> excludeEmail
oxTrustEntitlements --> excludeEntitlements
oxTrustExternalId --> excludeExternalId
oxTrustFaviconPath --> excludeFaviconPath
oxTrustImsValue --> excludeImsValue
oxTrustLocale --> excludeLocale
oxTrustLogoPath --> excludeLogoPath
oxTrustMetaCreated --> excludeMetaCreated
oxTrustMetaLastModified --> excludeMetaLastMod
oxTrustMetaLocation --> excludeMetaLocation
oxTrustMetaVersion --> excludeMetaVer
oxTrustMiddleName --> excludeMiddleName
oxTrustNameFormatted --> excludeNameFormatted
oxTrustPhoneValue --> excludePhoneValue
oxTrustPhotos --> excludePhotos
oxTrustProfileURL --> excludeProfileURL
oxTrustRole --> excludeRole
oxTrustStoreCert --> excludeStoreCert
oxTrustStoreConf --> excludeStoreConf
oxTrustTitle --> excludeTitle
oxTrustUserType --> excludeUsrTyp
oxTrustedDevicesInfo --> excludeedDevicesInf
oxTrusthonorificPrefix --> excludehonorificPrefix
oxTrusthonorificSuffix --> excludehonorificSuffix
oxTrustnickname --> excludenickname
oxTrustx509Certificate --> excludex509Certificate
oxType --> jsTyp
oxUmaPermission --> jsUmaPermission
oxUmaPolicyScriptDn --> jsUmaPolicyScrDn
oxUnlinkedExternalUids --> jsUnlinkedExternalUids
oxUrl --> jsUrl
oxValidation --> jsValidation
oxWebKeysSettings --> jsWebKeysSettings
oxX509PEM --> jsX509PEM
oxX509URL --> jsX509URL
oxdId --> jsdId
preferredUsername --> jsPrefUsrName
proStoresToken --> excludeProStoresTkn
researchAndScholarshipEnabled --> excludeResearchAndScholarshipEnabled
scimGroup --> jsScimgrp
softwareVersion --> jsSoftVer
